--------------------------------------------------------------------------------------------------------------------------------------------------------------------------------------------------------
--------------------------------------------------------------------------------------------------------------------------------------------------------------------------------------------------------
-------------------------------------------------------------------------------------?---------------------o----------------------------?????-----------------------------------------------------------
-----------------------------?----------o-----------------------------------M-------o-------------------------------------------------------------------------------------------------------------------
--------------------------------------------------------------------------------------------------------------------------------------------------------------------------------------------------------
---o-------------------------------------------------------------------------------------------------------------------------X--------------------------------------------------------------------M-----
--------------------------------------------------------------------------------------------------------------------------------------------------------------------------------------------------------
--------------------------------------------------------------------------------------------------------------------------T-------------------------------------------------------------------------?--v
----X--------------------------------------------M-------------------------------M?---------------------------------------|----------------------------------------------------------------------------f
----------------------------------------------------------X-------------o-------------------------------------------------|----------------------------------------------------------------------------f
----------------------B----------------------------------XX---------------------------------------------------------------|----------------------------------------------------------------------------f
--------------------------------------------------------XXX---------------------------------------------------------------|----------------------------------------------------------------------------f
-------------------------------------------------------XXXX---------------------------------------------------------------|----------------------------------------------------------X-----------------f
------------------------------------------------------XXXXX---------------------------------------------------------------|---------------------------------------------------------XX-----------------f
m----------------------------------------------------XXXXXX---------------------------------------------------------------|-----------E-------------------E----------------X-------XXX----------E------X
XXXXXXXXXXXXX-----XXXXXXXXXXXXXXXXXXXXXXX----------XXXXXXXXXXXXXXXXXXXXXXXXXXXXXXXXXXXXXXXXXXXXXXXXXXXXXXX-----XXXX???XXXX|XXXXXXXXXXXXXXXXXXXXXXXXXXXXXXXXXXXXXBBBXXXXXXXXXXXXXXXXXXXXXXXXXXXXXXXXXXXXX
