--------------------------------------------------------------------------------------------------------------------------------------------------------------------------------------------------------
------B-------------------------------------------------------------------------------------------------------------------------------------------------------------------------------------------------
----------------------------------------o---------------------------------------------------------------------------------------------------------------------------------------------------------------
----------------------?---------------------------------------------------------------------------------------------------------------------------------------------------------------------------------
-XX-----------------------------------------------------------------------------------------------------------------------------------------------------------------------------------------------------
---------------------------------------------------------------------------------------------------B---------------------------------------------------------------------------------------X------------
--------------------------------------------------------------------------------------------B-----------------------------------------------------------------------------------------------------------
---------------------------------------------------------------------------B---------------------------------------------------------------------------------------------------------------------------v
------------------------X------------------------------------------------------------------------------------------------------------------------------------------------------------------------------f
-------------------------------------------------------------------------------------------------------------------------------------------------------------------------------------------------------f
----------------------------------------------------------------------------------------------------------------------------------------------------------------------------------------------T-------Mf
----------------------------------------------------------------------------------------------------------------------------------------------------------------------------------------------|--------f
----------------------------------------------------------------------------------------------------------------------------------------------------------------------------------------------|--------f
----------------------------------------------------------------------------------------------------------------------------------------------------------------------------------------------|--------f
m---------------------------------------------------------------------------------------------------------------------------------------------------------------------------------------------|--------X
XXXXXXXXXXXXXXXXXXXXXXXXXXXXXXoXXXXXXXXX------X-XXXXXXXXXXXXXXXXXXXXXXXXXXXXXXXXXXXXXXXXXXXXXXXXXXXXXXXXXXXXXXXXXXXXXXXXXXXXX----XXXXXXXXXXXXXXXXXXXXXXXXXXXXXXXXXXXXXXXXXXXXXXXXXXXXXXXXXXXXX|XXXXXXXXX
