--------------------------------------------------------------------------------------------------------------------------------------------------------------------------------------------------------
------------B----------------------------------------------------------------------------------------------------------------------------------------------------------------------------------------BB-
--------------------------------------------------------------------------------------------------------------------------------------------------------------------------------------------------------
--------------------------------------------------------------------------------------------------------------------------------------------------------------------------------------------------------
-----------------------?---------------?------------------------------------------------------------------------------M------T--------------------------------------------------------------------------
-----------------------------------------------------------------------------------------------------------------------------|--------------------------------------------------------------------------
-----------------------------------------------------------------------------------------------------------------------------|--------------------------------------------------------------------------
-----------------------------------------------------------------------------------------------------------------------------|-------------------------------------------------------------------------v
-------------------------------------o---------------------------------------------------------------------------------------|-------------------------------------------------------------------------f
--------X--------------------------------------------------------------------------------------------------------------------|----------------------------X--------------------------------------------f
-------XX--------------------------------------------------------------------------------------------------------------------|-------------------------------------------------------------------------f
------XXX---------------------------------------------------------------------------------------------------o----------------|----------------------------------------------------------------T--------f
-----XXXX-------------------------------------------------------------------------------X------------------------------------|---------------o------------------------------------------------|-X------f
----XXXXX---------------------------------------T-----------------------------------------------M----------------------------|----------------------X-----------------------------------------|XX------f
m--XXXXXX---------------------------------------|-------------------------------------------------------------E--------------|----------------------XX----------------------------------------|XX------X
XXXXXXXXX---XXXXXXXXXXXXXXXXXXXXXXXXXXXXXXXXXXXX|XXXXXXXXXXXXXXXXXXXXXXXXXXXXXXXXXXXXXXX-XXXXXXX-------XXXXXXXXXXXXXXXXXXXXXX|XXXXXXXXXXXXXX--XXXXXXXXXXXXXXXXX----XXXXXXXXXXXXXXXXXXXXXXXXXXX|XXMXXXXXX
