--------------------------------------------------------------------------------------------------------------------------------------------------------------------------------------------------------
--------------------------------------------------------------------------------------------------------------------------------------------------------------------------------------------------------
--------------------------------------------------------------------------------------------------------------------------------------------------------------------------------------------------------
--------------------------------------------------------------------------------------------------------------------------------------------------------------------------------------------------------
-----------------------------------------------------------------------------------------------------------------------------------------------------------------------------------------------------o--
-------------------------------------------------------------------------------------------------------------------------------------------------------------------------------------------------???----
-o-----------------------------------T------------------------------------------------------------------------------------------------------------------------------------------------------------------
-------------------------------------|--B------------------------------------------------------------------B----------------------o--------------------------------------------------------------------v
-------------------------------------|-------------?---------------------------------------------------------------------------------------------------------------------------------------------------f
-------------------------------------|-------------o--------------------------------------------------------X------------------------------------------------------------------------------------------f
-------------------------------------|-----------------------------------------------------------------------------------------------------------------------------------------------------------------f
--------------B----------------------|--------------------------------------------------------------------------------------------------------------------T--------------------------------------------f
-------------------------------------|------------------------?-------------------------------------------------------------------------------------------|--------------------------------------------f
-o------T----------------------------|-----------------------------------------------------------------------------?--------------------------------------|-------------------------T-----------------Xf
m-------|----------------------------|----------------------------------------------------------------------------B---------------------------------------|----E--------------------|-----------------XX
XXXXXXXX|XXXXXXXXXXXXXXXXXXXXXXXXoXXX|XXXXXXXXXXXXXXXXXXXXXXXXXXXXXXXXXXXXXXXXXXXX-------XXXXXXX--XXXXXXXXXXXXXXXXXXXXXXXXXXXXXXXXXXXXXXXXXXXXXXXXXXXXXXXX|XXXXXXXXXXXXXXXXXXXXXXXX?|XXXXXXXXXXXXXXXXXXX
