------------------------?-------------------------------------------------------------------------------------------------------------------------------------------------------------------------------
--------------------------------------------------------------------------------------------------------------------------------------------------------------------------------------------------------
-------------------------------------------------------------------------------------------------------------o-------------------------------------------------------------------------------B----------
----------------------------------------o----------------------------------------------?----------------------------------------------------------------------------------------------------------------
-------------------------------------------------------------------------------------------------------------------------------------------------------------------------------T-----------X------------
---------M----------------T----------T------------------------------------------------------------------------------------????-------------------------------------------------|------------------------
--------------------------|---------T|---------------------------------???????---------------------------B---------------------------------------------------------------------|------------------------
--------------------------|---------||----------------------T------------------------------------------------------------------------------------------?-----------------------|-----------------------v
--------------------------|---------||----------------------|------------X------XXX--------------------------------------------------------------------------------------------|-----------------------f
-------------------------T|---------||----------------------|-----------XX-------------------------------------------T---------------------------------------------------------|-----------------------f
-------------------------||---------||----------------------|----------XXX-------o-----------------------------------|---------------------------------------------------------|-----------------------f
-------------------------||---------||----------------------|---------XXXX-------------------------------------------|---------------------------------------------------------|-----------------------f
--------?----------------||---------||----------------------|--------XXXXX-------------------------------------------|---------------------------------------------------------|-------------X---------f
---------------------????||---------||----------------------|-B-----XXXXXX-------------T-----------------------------|--------------------------------------------------------X|-------------XX---M----f
m----E-------------------||---------||--------E-------------|------XXXXXXX-------------|-------------E---------E-----|-----------------X-----X---------???-----E-------------XX|-----E-------XXX-----E-X
XXXXXXXXXXXXXXXXXXXXXXXXX||XoXXXXXXX||XXXXXX----XXXXXXXXX---|--XXXXXXXXXXXXXXXXXXXXXXXX|XXXXX--------XXXXXXXXXXXXXXXX|XXXXXXXXXXXXXXX----XXXXXXXXXXXXXXXXXXXXXXXXXXXXXXXXXXXXXX|XXXXXXXXXXXXXXXXXXXXXXXX
