--------------------------------------------------------------------------------------------------------------------------------------------------------------------------------------------------------
-----------------------------------------------------------------------------------------M--------------------------------------------------------------------------------------------------------------
---------------------------------?-----------------------------------------------------------------------------------------------------------------------------?----------------------------------------
--------------------------------------------------------------------------------------------T------------------------------------------------------BBB--------------------------------------------------
---------------------------------------------------------------------------------T----------|-----------------------------------------------------------------------------------------T-----------------
----------------------------------------B----------------------------------------|----------|----------------------------------------------------------------------------B-X----------|-----------------
---------------------X-----------------------------------------------------------|----------|-------------------------------------X-------X--------------------------------XX---------|-----------------
---------------------------------------------------------------------------------|-------T--|------------------------------------------------------------------------------XXX--------|----------------v
-T-------------------------------------------------------------------------------|-------|--|-----------------------------------------------------------------------X------XXXX-------|----------------f
-|-------------------------------------T---X-------------------------------------|-------|--|------------------------------------------------------------------------------XXXXX------|----------------f
-|-------------------------------------|---XX-----?------------------------------|---o---|--|------------------------------------------------------------------------------XXXXXX-----|----------------f
-|-------------------------------------|---XXX-----------------------------------|-----?-|--|-------------------------------------------------------X----------------------XXXXXXX----|----------------f
-|-------------------------------------|---XXXX----------------------------------|-------|--|-----------------------------o-------------------------XX---------------------XXXXXXXX---|-------------???f
-|-------------------------------------|---XXXXX---------------------------------|-------|--|-------------------------------------------------------XXX--------------------XXXXXXXXX--|----------------f
m|---------------X---------------------|---XXXXXX--------------------------------|-------|--|--------?----------------------------------------------XXXX--E----------------XXXXXXXXXX-|-E--------------X
X|XX--XXXXXXXXXXXXXXXXXXXXXXXX--------X|---XXXXXXXXXXXXXXXXXXXXXXXXXXXXXXXXXXXXXX|XXXX---|--|XXXXXXXXXXXX------XXXXXXXoXXXXXXXXXXXXXXXXXXXXXXXXXXXXXXXXXXXXXXXXXXXXXXXXXXXXXXXXXXXXXXX|XXXXXXXXXXXXXXXXX
