-----------------------------------------------------------------------------------------M--------------------------------------------------------------------------------------------------------------
--------------------------------------------------------------------------------------------------------------------------------------------------------------------------------------------------------
--------------------------------------------------------------------------------------------------------------------------------------------------?B----------------------------------------------------
-----------o--------------------------------------------------------------------------------------------------------------------------------------------------------------------------------------------
--------------------------------------------------------------------------------------------------------------------------------------------------------------------------------------------------------
---------------------------------------------------------------------?---------------------------------------------------------------------------------------------------X------------------------XXXXX-
-----------------------------------------------------------------------------X--------------------------------------------------------XX--------------------------------XX------------------------------
------------------------------------------------------------------------------------------------------------------------------------M----------------------------------XXX-------M---------------------v
----------------------------------------------------------------------------------------------------------------------------------------------------------------------XXXX-----------------------------f
---------------------------------------------------------------------------------------------------------------------------------------------------------------------XXXXX-----------------------------f
-------------------------------------------------------------------?------------------------------------------------------------------------------------------------XXXXXX-----------------------------f
--------------------M-----------------------------------------------------------------------------------------------------------------------------------------T----XXXXXXX-----------------------------f
----------------------------------------o--------------------------------------X------------------------------------------------------------------------------|---XXXXXXXX-----------------------------f
----------------------------------------------------X----------------------------------------------------------------------------------------T----------------|--XXXXXXXXX-----------------------------f
m---------------E-----E-----------------------------XX----E---------E----------------------------------B-------------------------------------|--------------??|?XXXXXXXXXX----------------------------EX
XXXXXXXXXXXXXXXXXXXXXXXXXXXXXXXXXXXXXXXXXXXXXX------XXXXXXXXXXXXXXXXXXXXXXXXXXXXXXXXXXXXXXXXXXX--------XXXXXXX?XXXXoXXXXXXX----XXXXXXXXXXXXXX|XXXXXXXXXXXXXXXX|XXXXXXXXXXXXXXXXXXXXXXXXXXXXXXXXXXXXXXXXX
