-----------------------------------------------------------------------------------------------------------------------------------------------------------------------------------------------M--------
------------------------------------------------------------------------------------XX-------------------------------------------------------------?-------------XXXXX----------------------------------
----------------------X--------X----------------o-------------------------------------------------------------------------------------------------------------------------------------------------------
-----------------------------------------------------------------------------------------------------------------------------------------------------------------o--------?--------?--------------------
---------------------------------------------------------------------------------------------------------------------------------?---------------B------------------------------------??----------------
---------T----------------------------------------------------------------------------------?????--------------------------------T--------------------T----------------------------------T---T--------X-
---------|----XXXXXXXX-------------------------------------X------------------------------------------------o--------------------|---------T----------|-------------------------------X--|---|--------X-
---------|-----------------------------------------------------------------------------------------------------------------------|X--------|----------|---T---------------------------XX-|---|--------Xv
--BBBBBB-|-----------------------------------------------------------------------------------------------------------T-----------|XX-------|----------|---|---------------------------XXX|---|--------Xf
---------|-----------------------------------------T-----------------------------------------------------------------|-----------|XXX--X---|----------|---|--------------------------MXXX|---|--------Xf
---------|-----------------------T-----------------|--------------------------------------------------------X--------|-----------|XXXX-----|----------|---|---------------------------XXX|X--|--------Xf
---------|-------------------T---|-----------------|--------------------------------------T----------------XX--------|-----------|XXXXX----|----------|---|---------------------------XXX|XX-|--------Xf
---BBBBBB|-------------------|---|-----------------|--------------------------------------|---------------XXX-------M|-----------|XXXXXX---|----------|---|---------------------------XXX|XXX|--------Xf
------?--|-------------------|---|-----------------|--------------------------------------|--------------XXXX--------|-----------|XXXXXXX--|----------|---|--------------X------------XXX|XXX|--------Xf
m--------|------E-------E----|---|-----------------|----------E---------E-----------------|-------------XXXXX--------|-E---?---E-|XXXXXXXX-|----------|---|--------------XX-----------XXX|XXX|X----E--XX
XXXXXXXXX|XXXXXXXXXXX-------X|XXX|XXXXXXXXXX---XXXX|XXXXXXXXXX--XXX--------XXXXXXXXX------|---XX-------XXXXXX-XXXXXXX|XXXXXXXXXXX|XXXXXXXXX|----XXXXXX|XXX|X---------XXXXXXX-------BBBXXX|XXX|XXX---XXXX
