--------------------------------------------------------------------------------o------------------------------------------------------------------o----------------------------------------------------
--------------------------------------------------------------------------------------------------------------------------------------------------------------------------------------------------------
--------------------------------------------------------------------B---------------------------------------------------------BBBBBBBB------------------------------------------------------------------
--------------------------------------------------------------------------------------------------------------------------------------------------------------------------------------------------------
--------------------------------------------------------------------------------------------------------------------------------------------------------------------------------------------------------
--------------------------------------------------------------------------------------------------------------------------------------------------------------------------------------------------------
-------------------------------------------------------------------M-------------------------------------------------------------M----------------------------------------------------------------------
-------------------------------------------------------------------------------------------------------------------------------------------------------------------------------------------------------v
--?-----------------------------------------------------------------------------------------------------------------------------------------------------------------------X----------------------------f
---o---------------------------------------------------------------------------------------------------------------------------------------------------------------------------------------------------f
----------------------------B---------------------------------------------------------BBBBBBBB---------------------------------------------------------------------------------------------------------f
-------------------------------------------------------------------------------------------------------------BBBBBBB---T-------------------------------------------T-----------------------------------f
----------------------------o----------------------------?-------------------------------------------------------------|-----------------------------------------X-|-----------------------------------f
-------------------------------------------------?---------------------------------------------------------------------|---------------------------------M---------|-----------------------------------f
mXE-----E-------E--------------------------------------E--------------------------------------------?-----------------E|-------------------------------------------|-------------------------------E---X
XXXXXXXXXXX----XXXXXXXXXXXXXXXXXXXXXXXXXXXXXoXXXXXXXXXXXXXXXXXXXXXXXXXXXXXXXMXXXXXXXXXXXXXXXXXXXXXXXXXXXXXXXXXXXXXXXXXX|XXXXXXXXXXXXXXXXXXXXXXXXXXXXXXXXXXXXXXXXXXX|XXXXXXXXXXXXXXXXXXXXXXXXXXXXXXXXXXXX
