--------------------------------------------------------------------------------------------------------------------------------------------------------------------------------------------------------
------------------------------------------??------------------------------------------------------------------------------------------------------------------------------------------------------------
-------------------------------------------------------------------------------------------------------------------------o-----------------------------------------M------------------------------------
---------------------------------------------------------------------------T----------------------------------------------------------------------------------------------------------------------------
-----o---------------------------------------------------------------------|----------------------------------------------------------------------------------------------------------------------------
---------------------------------------------------------------------------|----------------------------------------------------------------------------------------------------------------------------
-------BBBBB---------------------------------------------------------------|----------------------------------------------------------------------------------------------------------------------------
---------------------------------------------------------------------------|-----------------------------------B------------------------------------------------------------------T---o----------------v
--------------------------------------------------------------------------X|------------------------------------------------T-----------------------------------------------------|-----X----------X---f
--------------------------------------------------------------------------X|------------------------------------------------|--------------------------------------------X--------|----XX---------XX---f
--------------------------------------------------------------------------X|X-----------------------------------------------|-------------------------------------------XX-------T|---XXX--------XXX---f
----------X---------------------------------------------------------------X|XX--------------------------------X-------------|------------------------------------------XXX-------||--XXXX-------XXXX---f
--------------------------------------------------------------------------X|XXX---------------------------------------------|-----------------------------------------XXXX-------||-XXXXX------XXXXX---f
----------------------------------------------------------T---------------X|XXXX------------------------------------------M-|---------------------------------o------XXXXX-------||XXXXXX-----XXXXXX---f
m--------E-E---------------E------------------------------|---------------X|XXXXX-------------------------------------------|---------------------------------------XXXXXX-------||XXXXXX----XXXXXXX---X
XXXXXXXXXXXXXXXXXXXXXXXXXXXXXXXXXXXXXXXXXXXXXXBBBBBXXXXXXX|XXXXXXXXXXXXXXXX|XXXXXXXX---X----XXXXXXXXXXXXXXXXXXXXXXXXXXXXXXXX|XXXXXXXXXXXXXXXXXXXXXXXXXXXXXXXXXXXXXXXXXXXXX-----XX||XXXXXXXXXXXXXXXXXXXXX
