-------------------------------------------------------------------------------------------------------------------------------------------------------------------------------------------------BB-----
--------------------------------------------------------------------------------------------------------------------------------------------------------------------------------------------------------
--------------------------------------------------------------------------------------------------------------------------------------------------------------------------------------------------------
--------------------------------------------------------------------------------------------------------------------------------------------------------------------------------------------------------
--------------------------------------------------------------------------------------------------------------------------------------------------------------------------------------------------------
--------------------------------------------------------------------------------------------------------------------------------------------------------------------------------------------------------
--------------------------------------------------------------------------------------------------------------------------------------------------------------------------------------------------------
-----------------------------------------------------------------------------------------------------------------------------------------------------------------------X-------------------------------v
-------------------------------------------------------------------------------------------------------------------------------------------------------------------------------------------------------f
----------------------------------------------------------------------------------------------------------X--------------------------------------------------------------------------------------------f
--------------------------------------------------------------------------------------o------------------XX???--------------------------------------------------------------------X------------?-------f
--------------------------------------------------------------------------------------------------------XXX-----------------------------------------------------M----------------XX--------------------f
------------------------------------------------------T--------------X---------------------------------XXXX-------------o-------------------------------------------------------XXX--------X-----------f
------------------------------------------------------|-------------XX--------------------------------XXXXT--------------------------------------------------------------------XXXX--------XX----------f
m-----------------------------------------------------|------------XXX-------------------------------XXXXX|-----------------------------------------------------------------E-XXXXX--------XXX---------X
XXXXXXXXXXXXXXXXXXXXXXXXXXXXXX------XXXXXXXXXXXXXXXXX-|--XXXXXXXXXXXXXXXXXXXXXXXXXXXXXXXXXXXXXXXXXXXXXXXXX|XXXXXXXXXXXXXXXXXXXXXXXXXXXXXXXXXXXXXXXXXXXXXXXXXXXXXXXXXXXXXXXXXXXXXXXXMXXXXXXXXXXXXXXXXXXXX
