-----------------------------o--------------------------------------------------------------------------------------------------------------------------------------------------------------------------
------------?------------------------X--------------------------------------------------------------------------------------------------------M---------------------------------------------------------
------------------------------------------------------------------------------------------------------------------------------------------------B-------------------------------------------------------
--------------------------------------------------------------------XXXXXX------------------------------------------------------------------------------------------------------------------------------
------------B-------------------------------------------------------------------------------------------------------------------------------------------------------------------------------------------
-------------------------------------------o------------------------------------------------------------------------------------------------------------------------------------------------------------
-----o-------------------------------------------------------------------------------------------------------------------------------------------------------------------------------------T------------
-------------------------------------------------------------------------------------------------------------------------------------------------------------------------------------------|-----------v
----------------------------------o--------------------------X--------------M--------------------------------------------------------------------------------------------------------------|-----------f
--------------------------------------------???--------------XX-?----------T--------B------------------------------------------------------------------------------------------------------|-----------f
-------------------------------------------------------------XXX-----------|---------?---------------------------------------------------------------------o--X----------------------------|-----------f
--------T----------------------------------------------------XXXX----------|----------------------------------------------------------------------------------XX---------------------------|-----------f
--------|----------------------------------------------------XXXXX---------|----------------------------------------------------------------------------------XXX--------------------------|-----------f
--------|---------------------o------------------------------XXXXXX--------|----------------------------------------------------------------------------------XXXX-------------------------|--B--------f
m----E--|---------------------E------------E----------BBBB---XXXXXXX-------|EX----------------------------------E-----------------o--------------XXXXXX-------XXXXX--?--------------E-o----|---E---E---X
XXXXXXXX|XXXXXXXXX----XXXXXXXXXXXXXXXXBXXXXXXXXXXXXXXX-------XXXXXXXXXXXX--|XXXXXXXXXXXXXXXXXXXXXXXXXXXX----XXXXXXXXBBBXXXXXXXXXXXXXXXXXXXXXXXXXXXXXXXX---XXXXXXXXXXXXXXXX---BXXXXXXXXXXXXX|XXXXXXXXXXXX
