--------------------------------------------------------------------------------------------------------------------------------------------------------------------------B-----------------M-----------
------------------------------------------------o----------------------------M---------------------------------------------------------------------------------------XXXXXXX----------------------------
-------------------------------------------------------o------------------------------------------------------------------------------------------------------------------------------------------------
-------------------------?------------------------------------------------------------------------------------------------------------------------------------------------------------------------------
----o-----------------------------------------------------------------------------------------------------------o---------------------------------------------------------------------------------------
----------------------o---------------------------------------------------------------------------------------------------------------------------------------------------------------------------------
---------------------------------------------------------------------------------------------------------------------------------------------------------------------------------------X----------------
-----------------------------------------------------------------------------------------------oXXX------------------------------------------------------------------------------------XX--------------v
-----------------------------------------------------------------------------------------------------------------------------X------T--------------------------------------------------XXX-------------f
-----------------------------------------------------------------------------------------------------------------------------XX----X|---------------T----------------------------------XXXX------------f
-----------------------------------------------------------------------------------------------------------------------X-----XXX--XX|---------------|----------------------------------XXXXX-----------f
--------------------------?BBBBBB---------------------------------------------------------------X----------------------XX----XXXXXXX|---------------|----------------------------------XXXXXX----------f
-----------------------------------------------------------------------------------------------------------------------XXX---XXXXXXX|---------------|----------------------------------XXXXXXX---------f
------------------------------------------o-----------------------------------------------------------X----------------XXXX--XXXXXXX|---------------|----------------------------------XXXXXXXX--------f
m------------------E-E---------------------E-E-----------------??---------------------------------------XXXXXXXX-------XXXXX-XXXXXXX|---------------|----------------------------------XXXXXXXXX-------X
XXXXXXX---XXXXX-XXXXXXXXXXXXXXXXXXXXXXXXXXXXXXXXXXXXXXXXXXXXXXXXXXXXXXXXXX----XXXXXXXXXXXXXXXXXXXXXXXXXXXXXXXXXXXXXXXXXXXXXXXXXXXXXX|-XXXXXXXXXXXXXX|XXXXXXXXXXXXXXXXXXXXXXXXXXXXXXXXXXXXXXXXXXXX----XXX
