-----M-------?---------M-T--o-T-X-------|-o-----X?----------B-------------o-------X-----T-|-----------------B----M----------|TB------X--ToE------M--M--X----B-?-X---X----oE---------------EoX--------T--
--M-----X-------------------?---M----------M-|-------------?--------EE-E--o--B|---------------TX-E----o-X--B------|--M--------M------M------------B-------T|------------XET----------T---o--------o-o-T-
-----B-----X-----------E----MB---o-------o-X-?o----Eo------------B--X--B--------X----------?--?|--------oT---T---B----------------|-M-------M--------E--B------EE----?-----------Mo----E-E--E-----------
-------------M-B-E--------BT-o-B-M------?----B-X--o--------TT-?-|------XE------?--o---T-B-M-------E?-?--------------oE---X-ME--B---X-------------M-B---------T----E---M|-B------E----M-----M-E-E--------
-T-T------------E-------|-E-E---o---T----------B-T----X-----T----E--o-------??-----------T-X--o------------E-------o--M-------E-M?---B------|---------------B--------X----?-ETB----------X-|-T---B-M----
-T------?------|-Bo-----EEE--E-MoX----X-T------------X-E-TE---------M--T-----?-----T-------M---------|---X---B--?---o-----E---o--M----|o------X-E---M--T----------T-|----------M------B-----------------
--MB----------ME-?-T-o------T--X-BM|--M----?X------|----------E--o?---------o----------M-----T-------X-M---EM-M--M-|-?----E--B-------T------------T-------T------------E-------|B--o-------?-o--E--o----
-----M---M--o--T----XXET---|----T|-----E-o-------------------M-----o----o-----?MME?o-----|------------E---------------------||--T-T---E-T------?|------------X----E-------X-TMo---M--|-X------XM-o--T-Tv
--T-----o---MB---B----E-ooB--------------------X----X-----------o--??X--o?---X--------o--o-|-----------|ET--E----|----X-E--B----------?-----o-?-X--------o--E--Eo--------M-----T---------|--T-----?-B-Tf
--------X-------o-----T---o-M-M---T--X--M|E-----X--M------------o-M--T-T-----o--EE----------?-E?----M-------------o------M-M-o-?--T-MTB----|---------M--M------X---T-o----X|M-------X------|-----T--E--f
-------M|o|B-----------X-E----?-B-E?----------X--o--E----XE------B----E----oT------E--o----------E---------|-----XT-------o-------X--M-----?--X-------E---B--------oT--|---X---------E-----------E--o--f
-------|T|---?-------o---------E|-B-----|---|M-----oM-----E?-E-|----------MM--B----o----|--o-E-------B----E----B-MM-|--MM-----M--M------------TE----E-----------MB-BE--------?----BM--------T-|-B---?--f
-------|-----o-o--B-B--X?o---B------T---B--EX------E---E---M----o-------o----------E------------o-T--------o--------X-------------------M-X--?E---|--M----M---T---E|-EX----o--|---------B-----?----T||-f
--?-X------o|-M---T------?-----Xo-|X---E----o---M-------X---B?-|--------?-----M-----T---|---------X---?---o-|M---M--|--------B-XT-----------|----------------M---M--o--E-------|---o--?--------TB----X-f
m-E--------------MB|T----B-?---|M-?-----?-------X---|-----?------M--T----B-------------B--|EM-----E--------o||E---------M--M-------------B--------E-o------M?---------M??|T---|T------?---B-?---B-o----X
XXXXXXXXXXXXXXXXXXXXXXXXXXXXXXXXXXXXXXXXXXXXXXXXXXXXXXXXXXXXXXXXXXXXXXXXXXXXXXXXXXXXXXXXXXXXXXXXXXXXXXXXXXXXXXXXXXXXXXXXXXXXXXXXXXXXXXXXXXXXXXXXXXXXXXXXXXXXXXXXXXXXXXXXXXXXXXXXXXXXXXXXXXXXXXXXXXXXXXXX
