-----------|--EE----?T------B--To---?-M-------T--T-o------TE--------?---o-------X--M----ET--------T-XM---o-E-------|---------?----Xo-----|-----E-----M----o------M-----B-X----------B-----o----T--------
-----o----------------o--------------|-T-E---B--?----------T-----------B--------E---?--------o-M----X-o?T--------|BM-----o---------XB--B---B-o-E-B--B-X----ETB---B----B-o-----------T-----E?--------T---
-----?-----XE------X------E---M-E--|----?-?---|E--------------?--T--T-|-------T-B-T|-?-oB-----M----M----?--------B---------M|M--E?-----------BB--B-?----M-E---?--o--------T---T---------------------E---
---------------M---E-ETo-BE----X------------o------M---B--M----B----X----------X----------?---?------B|?--T---|-----------E--------------T--?---B--------|---o--BE?---------|-B---------------M---------
----?--?-------B--M----T----?-----|---B-------?-----------M---T--|XX--Mo-------?----E--------------T--T------------X-?--|--E--E--T--M?----T-|-----T-----?oTM--|----------T---M-----------------E-X------
--------------o--X-X-B----------B-M|-o|------M--BX----------T?-T--|---------?-----TXT--M-o------X-----oB---E------|-----E--|--E---X-----X-X------M--X-M-X--?---------E--o------T--X-?----------|-XX--E--
----B----------T--------o--?-?--------o-B-----------M--|------M|-----X-X--M-------M------MX--o--o-----X---T-----------B--ME---M------------?---E---X-------------E-?------M--E--B?-----------B------o---
----------EB-----------o-E-----X---T|-------?-M----------M-?T-?-E----MM-T--E----------T-E----|--------------M-M--------?B----|-------------M-----o--------M-------E--T----M-|-----|-------------E------v
-----BX--M--------E--|T-|--X---X----------M-?----------M|-------B----B----XE?---------------E-------?-o---------X-|o--M-------o---------|--BE--------------MB-----o--T-----E---M--X--|-------M-?M-----?f
----X-E---EM----E------M----X---------T-------?---M-BB-T-------To-Mo--MM-----T----B-----E--X------B------X---o---MM---|---o-E-----?M----E----BE------|--o---------E-?M?o---B------X--B-B--?----XX------f
----?o-----oB----B--|---|------------------M-|---|---T------------EX--B-MT-?-|---EM-T----------XE-------oE--------TE--------|T-----M----------------------XM--------------------M----?----------T---X--f
---?|------------M-B|------------M---E----------------M-------------------|---B---------?-----XE-----E------------M---oB--To|----|o--------o-------|---------X---o------E--E--------o----------?o-T--TMf
----M--M--X---?---M--M----------------|-o-E----oB--|--M--|----B--E-M--M--------T--B-T-E--|o-EM---|------B---------B---------------o--o----------?-----E-----|-------|M-E--|---|----------|-------------f
---X--------------?----T-?--o-B---M------?o-?----T----E------B----------TEB------X------------E--|o----------o-o------E?--------BX---Eo---X------X---o----------XB---T---------------X------X---o?---B-f
m---M--------X----?o-o--------E--BM-------MX-----M------M---------o-X----M-----M-------E----E----?--------------?-T-----Mo----------------|--------------oE-----------TE-----EB-----o--B----X-X------X-X
XXXXXXXXXXXXXXXXXXXXXXXXXXXXXXXXXXXXXXXXXXXXXXXXXXXXXXXXXXXXXXXXXXXXXXXXXXXXXXXXXXXXXXXXXXXXXXXXXXXXXXXXXXXXXXXXXXXXXXXXXXXXXXXXXXXXXXXXXXXXXXXXXXXXXXXXXXXXXXXXXXXXXXXXXXXXXXXXXXXXXXXXXXXXXXXXXXXXXXXX
