----------|----------|-----|------|------------|------------|---|-|-|--|---|----------|-----|------|------|--------------------|----|-----|---|-------|--|-------------------|--|---------|--|----------
----------|----------|-----|------|------------|------------|---|-|-|--|---|----------|-----|------|------|--------------------|----|-----|---|-------|--|-------------------|--|---------|--|----------
----------|----------|-----|------T------------|------------|---|-T-T--T---|----------T-----|------|------T--------------------|----T-----|---T-------|--|-------------------|--|---------T--|----------
----------|----------|-----|-------------------|------------T---|----------|----------------|------T---------------------------|----------|-----------T--T-------------------|--|------------T----------
----------T----------T-----T-------------------T----------------T----------T----------------T----------------------------------T----------T----------------------------------T--T-----------------------
-------------------o-----------o----------o-o--------o--------------o-----o--------------o------------------o--------------oo-----------o--o---------o-----------o---o--o---o-o-----------oo------------
-------------o---o---------o------o----------o----------------------o-o-----o---------------------o--o-o--o-o---o------------------------o----o--o--------------------o-o-------------o-----------------
----------o--o-o------oo--oo-oo--------o------------o------o---------------------------o--------------o--oo--------o-o-o--------o---o------o----o--------------------------o----o--------oo------------v
----------oo-----o------o------------o---------------------o----o---------------o-------oo-----------------oo-----o----------o--------o-----o------o--------o--oo-------------o-----o-----o------------f
-----------o------o----------o-----------oo-o--------------------oo----------------------------o----------------o---o--------------oo-----------------------------o--o---------------------------------f
------------oo----------------oE--o--------------------------E-ooEE-------------------o-----o--E--EEE-o-oE-o--o----o---oo----o----Eo----o-E--E--o--------------o--E--Eo---E---------E------------------f
----------o----T-----------T-M??M?o--o------------o-----------?B?B?B-T------T--------o-To---o--MBBMBooo-M--------o-To---T--------MB?--?o----T---T-----o--------M?BM?MB---------B--------oo--oT---------f
------------T--|--------o--|-o-----------------T-------o--o---------o|------|-T--------|-o-------------o-----------|----|----o--------------|---|-o--o----------o---o--o-----------------o---|---------f
------------|--|-----------|-------------o--T-o|-------T-------------|--oE--|-|-----T--|-------T-oo---o-----oT--oo-|---o|-E--E-------o------|---|--------oT----------------T-------o----o----|---------f
m-----------|--|-----------|---E------------|--|--E----|-T-T-E---TE-E|--EE--|-|-EE-E|-E|-E-E---|--EE-E---E-E-|--EEE|---E|----EE-E-E-E--EE-E-|---|-EEEE---E|-E-EE-EE--E--E-E|----EE-EE-T---E--|---------X
XXXXXXXXXX--|-X|-X--XXXXX--|-XXXXX----XXXXX-|--|-XXXX--|-XXX-----XXXX|--XXXX|-|-XXXX|-X|-XX----|-XXXX--XXXXX-|---XX|-X--|-XXXX---XXXXX---XXX|---|-XXXXX---|-XXX--XXXXX--XXX|-----XXXXX--XXXXX|-XXXXXXXXX
